Aacute=A+acutecomb@top
aacute=a+acutecomb@top
Abreve=A+brevecomb@top
abreve=a+brevecomb@top
Abreveacute=A+brevecomb_acutecomb@top
abreveacute=a+brevecomb_acutecomb@top
Abrevedotbelow=A+brevecomb@top+dotbelowcomb@bottom
abrevedotbelow=a+brevecomb@top+dotbelowcomb@bottom
Abrevegrave=A+brevecomb_gravecomb@top
abrevegrave=a+brevecomb_gravecomb@top
Abrevehookabove=A+brevecomb_hookabovecomb@top
abrevehookabove=a+brevecomb_hookabovecomb@top
Abrevetilde=A+brevecomb_tildecomb@top
abrevetilde=a+brevecomb_tildecomb@top
Acircumflex=A+circumflexcomb@top
acircumflex=a+circumflexcomb@top
Acircumflexacute=A+circumflexcomb_acutecomb@top
acircumflexacute=a+circumflexcomb_acutecomb@top
Acircumflexdotbelow=A+circumflexcomb@top+dotbelowcomb@bottom
acircumflexdotbelow=a+circumflexcomb@top+dotbelowcomb@bottom
Acircumflexgrave=A+circumflexcomb_gravecomb@top
acircumflexgrave=a+circumflexcomb_gravecomb@top
Acircumflexhookabove=A+circumflexcomb_hookabovecomb@top
acircumflexhookabove=a+circumflexcomb_hookabovecomb@top
Acircumflextilde=A+circumflexcomb_tildecomb@top
acircumflextilde=a+circumflexcomb_tildecomb@top
Adblgrave=A+dblgravecomb@top
adblgrave=a+dblgravecomb@top
Adieresis=A+dieresiscomb@top
adieresis=a+dieresiscomb@top
Adotbelow=A+dotbelowcomb@bottom
adotbelow=a+dotbelowcomb@bottom
AEacute=AE+acutecomb@top
aeacute=ae+acutecomb@top
Agrave=A+gravecomb@top
agrave=a+gravecomb@top
Ahookabove=A+hookabovecomb@top
ahookabove=a+hookabovecomb@top
Ainvertedbreve=A+breveinvertedcomb@top
ainvertedbreve=a+breveinvertedcomb@top
Amacron=A+macroncomb@top
amacron=a+macroncomb@top
Aogonek=A+ogonekcomb@ogonek
aogonek=a+ogonekcomb@ogonek
Aring=A+ringcomb@top
aring=a+ringcomb@top
Aringacute=A+ringcomb_acutecomb@top
aringacute=a+ringcomb_acutecomb@top
Atilde=A+tildecomb@top
atilde=a+tildecomb@top
Cacute=C+acutecomb@top
cacute=c+acutecomb@top
Ccaron=C+caroncomb@top
ccaron=c+caroncomb@top
Ccedilla=C+cedillacomb@bottom
ccedilla=c+cedillacomb@bottom
Ccircumflex=C+circumflexcomb@top
ccircumflex=c+circumflexcomb@top
Cdotaccent=C+dotaccentcomb@top
cdotaccent=c+dotaccentcomb@top
dcaron=d+caroncomb.alt@caron.alt
Dcaron=D+caroncomb@top
Eacute=E+acutecomb@top
eacute=e+acutecomb@top
Ebreve=E+brevecomb@top
ebreve=e+brevecomb@top
Ecaron=E+caroncomb@top
ecaron=e+caroncomb@top
Ecircumflex=E+circumflexcomb@top
ecircumflex=e+circumflexcomb@top
Ecircumflexacute=E+circumflexcomb_acutecomb@top
ecircumflexacute=e+circumflexcomb_acutecomb@top
Ecircumflexdotbelow=E+circumflexcomb@top+dotbelowcomb@bottom
ecircumflexdotbelow=e+circumflexcomb@top+dotbelowcomb@bottom
Ecircumflexgrave=E+circumflexcomb_gravecomb@top
ecircumflexgrave=e+circumflexcomb_gravecomb@top
Ecircumflexhookabove=E+circumflexcomb_hookabovecomb@top
ecircumflexhookabove=e+circumflexcomb_hookabovecomb@top
Ecircumflextilde=E+circumflexcomb_tildecomb@top
ecircumflextilde=e+circumflexcomb_tildecomb@top
Edblgrave=E+dblgravecomb@top
edblgrave=e+dblgravecomb@top
Edieresis=E+dieresiscomb@top
edieresis=e+dieresiscomb@top
Edotaccent=E+dotaccentcomb@top
edotaccent=e+dotaccentcomb@top
Edotbelow=E+dotbelowcomb@bottom
edotbelow=e+dotbelowcomb@bottom
Egrave=E+gravecomb@top
egrave=e+gravecomb@top
Ehookabove=E+hookabovecomb@top
ehookabove=e+hookabovecomb@top
Einvertedbreve=E+breveinvertedcomb@top
einvertedbreve=e+breveinvertedcomb@top
Emacron=E+macroncomb@top
emacron=e+macroncomb@top
Eogonek=E+ogonekcomb@ogonek
eogonek=e+ogonekcomb@ogonek
Etilde=E+tildecomb@top
etilde=e+tildecomb@top
Gbreve=G+brevecomb@top
gbreve=g+brevecomb@top
Gcaron=G+caroncomb@top
gcaron=g+caroncomb@top
Gcircumflex=G+circumflexcomb@top
gcircumflex=g+circumflexcomb@top
Gcommaaccent=G+commaaccentcomb@bottom
gcommaaccent=g+commaturnedabovecomb@top
Gdotaccent=G+dotaccentcomb@top
gdotaccent=g+dotaccentcomb@top
Hcircumflex=H+circumflexcomb@top
hcircumflex=h+circumflexcomb@top
Iacute=I+acutecomb@top
iacute=idotless+acutecomb@top
Ibreve=I+brevecomb@top
ibreve=idotless+brevecomb@top
Icircumflex=I+circumflexcomb@top
icircumflex=idotless+circumflexcomb@top
Idblgrave=I+dblgravecomb@top
idblgrave=idotless+dblgravecomb@top
Idieresis=I+dieresiscomb@top
idieresis=idotless+dieresiscomb@top
Idotaccent=I+dotaccentcomb@top
idotaccent=idotless+dotaccentcomb@top
Idotbelow=I+dotbelowcomb@bottom
idotbelow=i+dotbelowcomb@bottom
Igrave=I+gravecomb@top
igrave=idotless+gravecomb@top
Ihookabove=I+hookabovecomb@top
ihookabove=idotless+hookabovecomb@top
Iinvertedbreve=I+breveinvertedcomb@top
iinvertedbreve=idotless+breveinvertedcomb@top
Imacron=I+macroncomb@top
imacron=idotless+macroncomb@top
Iogonek=I+ogonekcomb@ogonek
iogonek=i+ogonekcomb@ogonek
Itilde=I+tildecomb@top
itilde=idotless+tildecomb@top
Jcircumflex=J+circumflexcomb@top
jcircumflex=jdotless+circumflexcomb@top
Kcommaaccent=K+commaaccentcomb@bottom
kcommaaccent=k+commaaccentcomb@bottom
Lacute=L+acutecomb@top
lacute=l+acutecomb@top
Lcaron=L+caroncomb.alt@caron.alt
lcaron=l+caroncomb.alt@caron.alt
Lcommaaccent=L+commaaccentcomb@bottom
lcommaaccent=l+commaaccentcomb@bottom
Ldot=L+dotaccentcomb@dot
ldot=l+dotaccentcomb@dot
Nacute=N+acutecomb@top
nacute=n+acutecomb@top
Ncaron=N+caroncomb@top
ncaron=n+caroncomb@top
Ncommaaccent=N+commaaccentcomb@bottom
ncommaaccent=n+commaaccentcomb@bottom
Ntilde=N+tildecomb@top
ntilde=n+tildecomb@top
Oacute=O+acutecomb@top
oacute=o+acutecomb@top
Obreve=O+brevecomb@top
obreve=o+brevecomb@top
Ocircumflex=O+circumflexcomb@top
ocircumflex=o+circumflexcomb@top
Ocircumflexacute=O+circumflexcomb_acutecomb@top
ocircumflexacute=o+circumflexcomb_acutecomb@top
Ocircumflexdotbelow=O+circumflexcomb@top+dotbelowcomb@bottom
ocircumflexdotbelow=o+circumflexcomb@top+dotbelowcomb@bottom
Ocircumflexgrave=O+circumflexcomb_gravecomb@top
ocircumflexgrave=o+circumflexcomb_gravecomb@top
Ocircumflexhookabove=O+circumflexcomb_hookabovecomb@top
ocircumflexhookabove=o+circumflexcomb_hookabovecomb@top
Ocircumflextilde=O+circumflexcomb_tildecomb@top
ocircumflextilde=o+circumflexcomb_tildecomb@top
Odblgrave=O+dblgravecomb@top
odblgrave=o+dblgravecomb@top
Odieresis=O+dieresiscomb@top
odieresis=o+dieresiscomb@top
Odieresismacron=O+dieresiscomb_macroncomb@top
odieresismacron=o+dieresiscomb_macroncomb@top
Odotaccentmacron=O+dotaccentcomb_macroncomb@top
odotaccentmacron=o+dotaccentcomb_macroncomb@top
Odotbelow=O+dotbelowcomb@bottom
odotbelow=o+dotbelowcomb@bottom
Ograve=O+gravecomb@top
ograve=o+gravecomb@top
Ohookabove=O+hookabovecomb@top
ohookabove=o+hookabovecomb@top
Ohorn=O+horncomb@horn
ohorn=o+horncomb@horn
Ohornacute=O+horncomb@horn+acutecomb@top
ohornacute=o+horncomb@horn+acutecomb@top
Ohorndotbelow=O+horncomb@horn+dotbelowcomb@bottom
ohorndotbelow=o+horncomb@horn+dotbelowcomb@bottom
Ohorngrave=O+horncomb@horn+gravecomb@top
ohorngrave=o+horncomb@horn+gravecomb@top
Ohornhookabove=O+horncomb@horn+hookabovecomb@top
ohornhookabove=o+horncomb@horn+hookabovecomb@top
Ohorntilde=O+horncomb@horn+tildecomb@top
ohorntilde=o+horncomb@horn+tildecomb@top
Ohungarumlaut=O+hungarumlautcomb@top
ohungarumlaut=o+hungarumlautcomb@top
Oinvertedbreve=O+breveinvertedcomb@top
oinvertedbreve=o+breveinvertedcomb@top
Omacron=O+macroncomb@top
omacron=o+macroncomb@top
Oogonek=O+ogonekcomb@ogonek
oogonek=o+ogonekcomb@ogonek
Oslashacute=Oslash+acutecomb@top
oslashacute=oslash+acutecomb@top
Otilde=O+tildecomb@top
otilde=o+tildecomb@top
Otildemacron=O+tildecomb_macroncomb@top
otildemacron=o+tildecomb_macroncomb@top
Racute=R+acutecomb@top
racute=r+acutecomb@top
Rcaron=R+caroncomb@top
rcaron=r+caroncomb@top
Rcommaaccent=R+commaaccentcomb@bottom
rcommaaccent=r+commaaccentcomb@bottom
Rdblgrave=R+dblgravecomb@top
rdblgrave=r+dblgravecomb@top
Rinvertedbreve=R+breveinvertedcomb@top
rinvertedbreve=r+breveinvertedcomb@top
Sacute=S+acutecomb@top
sacute=s+acutecomb@top
Scaron=S+caroncomb@top
scaron=s+caroncomb@top
Scedilla=S+cedillacomb@bottom
scedilla=s+cedillacomb@bottom
Scircumflex=S+circumflexcomb@top
scircumflex=s+circumflexcomb@top
Scommaaccent=S+commaaccentcomb@bottom
scommaaccent=s+commaaccentcomb@bottom
tcaron=t+caroncomb.alt@caron.alt
Tcaron=T+caroncomb@top
Tcedilla=T+cedillacomb@bottom
tcedilla=t+cedillacomb@bottom
Tcommaaccent=T+commaaccentcomb@bottom
tcommaaccent=t+commaaccentcomb@bottom
Uacute=U+acutecomb@top
uacute=u+acutecomb@top
Ubreve=U+brevecomb@top
ubreve=u+brevecomb@top
Ucircumflex=U+circumflexcomb@top
ucircumflex=u+circumflexcomb@top
Udblgrave=U+dblgravecomb@top
udblgrave=u+dblgravecomb@top
Udieresis=U+dieresiscomb@top
udieresis=u+dieresiscomb@top
Udotbelow=U+dotbelowcomb@bottom
udotbelow=u+dotbelowcomb@bottom
Ugrave=U+gravecomb@top
ugrave=u+gravecomb@top
Uhookabove=U+hookabovecomb@top
uhookabove=u+hookabovecomb@top
Uhorn=hornU+horncomb@horn
uhorn=hornu+horncomb@horn
Uhornacute=hornU+horncomb@horn+acutecomb@top
uhornacute=hornu+horncomb@horn+acutecomb@top
Uhorndotbelow=hornU+horncomb@horn+dotbelowcomb@bottom
uhorndotbelow=hornu+horncomb@horn+dotbelowcomb@bottom
Uhorngrave=hornU+horncomb@horn+gravecomb@top
uhorngrave=hornu+horncomb@horn+gravecomb@top
Uhornhookabove=hornU+horncomb@horn+hookabovecomb@top
uhornhookabove=hornu+horncomb@horn+hookabovecomb@top
Uhorntilde=hornU+horncomb@horn+tildecomb@top
uhorntilde=hornu+horncomb@horn+tildecomb@top
Uhungarumlaut=U+hungarumlautcomb@top
uhungarumlaut=u+hungarumlautcomb@top
Uinvertedbreve=U+breveinvertedcomb@top
uinvertedbreve=u+breveinvertedcomb@top
Umacron=U+macroncomb@top
umacron=u+macroncomb@top
Uogonek=U+ogonekcomb@ogonek
uogonek=u+ogonekcomb@ogonek
Uring=U+ringcomb@top
uring=u+ringcomb@top
Utilde=U+tildecomb@top
utilde=u+tildecomb@top
Wacute=W+acutecomb@top
wacute=w+acutecomb@top
Wcircumflex=W+circumflexcomb@top
wcircumflex=w+circumflexcomb@top
Wdieresis=W+dieresiscomb@top
wdieresis=w+dieresiscomb@top
Wgrave=W+gravecomb@top
wgrave=w+gravecomb@top
Yacute=Y+acutecomb@top
yacute=y+acutecomb@top
Ycircumflex=Y+circumflexcomb@top
ycircumflex=y+circumflexcomb@top
Ydieresis=Y+dieresiscomb@top
ydieresis=y+dieresiscomb@top
Ydotbelow=Y+dotbelowcomb@bottom
ydotbelow=y+dotbelowcomb@bottom
Ygrave=Y+gravecomb@top
ygrave=y+gravecomb@top
Yhookabove=Y+hookabovecomb@top
yhookabove=y+hookabovecomb@top
Ymacron=Y+macroncomb@top
ymacron=y+macroncomb@top
Ytilde=Y+tildecomb@top
ytilde=y+tildecomb@top
Zacute=Z+acutecomb@top
zacute=z+acutecomb@top
Zcaron=Z+caroncomb@top
zcaron=z+caroncomb@top
Zdotaccent=Z+dotaccentcomb@top
zdotaccent=z+dotaccentcomb@top